Xoi, Xoi, Xoi, Xoi, Xoi, Xoi, Xoi, Xoi, Xoi, Xoi, Xoi, Xoi, Xoc, Xoc, Xoc, Xoc, Xoc, Xoc, Xoc, Xoc, Xoc, Xoc, Xoc, Xoc, Xoc, Xoc, Xoc, Xoc, Xoc, Xoc, Xoc, Xoc, Xoc, Xoi, Xoi, Xoi, Xoi, Xoi, Xoi, Xoi, Xoi, Xoi, Xoc
Xoi, Icn, Icn, Icn, Icn, Icn, Icn, Icn, Icn, Xoi, Irs, Irs, Xoc, Icr, Icr, Icr, Icr, Icr, Icr, Cha, Cha, 8 Kha, Cha, Cha, Icr, Icr, Icr, Icr, Icr, Icr, Xoc, Irs, Irs, Xoi, Icn, Icn, Icn, Icn, Icn, Icn, Icn, Icn, Xoc
Xoi, Icn, Icn, Icn, Icn, Icn, Icn, Icn, Ch, Xoi, Irs, Irs, Xoc, Icr, Icr, Xoc, Xoc, Icr, Xoc, Cha, Cha, Cha, Cha, Cha, Xoc, Icr, Xoc, Xoc, Icr, Icr, Xoc, Irs, Irs, Xoi, Ch, Icn, Icn, Icn, Icn, Icn, Icn, Icn, Xoc
Xoc, Xoi, Xoi, Xoi, Xoi, Xoi, Xoi, Xoi, Irs, Irs, Irs, Irs, Xoc, Icr, Icr, Icr, Icr, Xoc, Icr, Xoc, Icr, Cha, Icr, Xoc, Icr, Xoc, Icr, Icr, Icr, Icr, Xoc, Irs, Irs, Irs, Irs, Xoi, Xoi, Xoi, Xoi, Xoi, Xoi, Xoi, Xoc
Xoc, Irs, Irs, Irs, Irs, Irs, Irs, Irs, Irs, Irs, Xoc, Xoc, Xoc, Icr, Icr, Icr, Icr, Icr, Icr, Icr, Icr, Icr, Icr, Icr, Icr, Icr, Icr, Icr, Icr, Icr, Xoc, Xoc, Xoc, Irs, Irs, Irs, Irs, Irs, Irs, Irs, Irs, Irs, Xoc
Xoc, Irs, Irs, Irs, Irs, Irs, Irs, Irs, Irs, Irs, Irs, Irs, Irs, Irs, Irs, Icr, Icr, Icr, Icr, Icr, Xoi, Xoi, Xoi, Icr, Icr, Icr, Icr, Icr, Irs, Irs, Irs, Irs, Irs, Irs, Irs, Irs, Irs, Irs, Irs, Irs, Irs, Irs, Xoc
Xoc, Irs, Irs, Irs, Irs, Irs, Xoc, Xoc, Irs, Irs, Irs, Irs, Irs, Irs, Irs, Irs, Xoc, Icr, Irs, Xoi, Icn, Icn, Icn, Xoi, Irs, Icr, Xoc, Irs, Irs, Irs, Irs, Irs, Irs, Irs, Xoc, Irs, Irs, Irs, Irs, Irs, Irs, Irs, Xoc
Xoc, Irs, Irs, Irs, Irs, Irs, Irs, Xoc, Xoc, Irs, Irs, Irs, Irs, Irs, Xoc, Xoc, Xoc, Irs, Irs, Xoi, Xoi, Rr^Pw|o, Xoi, Xoi, Irs, Irs, Xoc, Xoc, Xoc, Irs, Irs, Irs, Irs, Irs, Xoc, Xoc, Irs, Irs, Irs, Irs, Irs, Irs, Xoc
Xoc, Irs, Irs, Irs, Irs, Irs, Irs, Irs, Irs, Xoc, Xoc, Irs, Xoc, Xoc, Irs, Irs, Xoc, Irs, Irs, Irs, Irs, Rr^Pw|o, Irs, Irs, Irs, Irs, Xoc, Irs, Irs, Xoc, Xoc, Irs, Xoc, Xoc, Irs, Irs, Irs, Irs, Irs, Irs, Irs, Irs, Xoc
Xoc, Rrc, Rrc, Irs, Irs, Irs, Irs, Irs, Irs, Irs, Irs, Xoc, Irs, Irs, Irs, Irs, Xoc, Irs, Irs, Irs, Irs, Irs, Irs, Irs, Irs, Irs, Xoc, Irs, Irs, Irs, Irs, Xoc, Irs, Irs, Irs, Irs, Irs, Irs, Irs, Irs, Rrc, Rrc, Xoc
Xoc, Rrc, Rrc, Xoc, Xoc, Irs, Irs, Irs, Irs, Irs, Irs, Irs, Irs, Irs, Irs, Irs, Xoc, Irs, Xoc, Xoc, Irs, Irs, Irs, Xoc, Xoc, Irs, Xoc, Irs, Irs, Irs, Irs, Irs, Irs, Irs, Irs, Irs, Irs, Irs, Xoc, Xoc, Rrc, Rrc, Xoc
Xoc, Rrc, Rrc, Xoc, Irs, Xoc, Xoc, Irs, Irs, Irs, Irs, Irs, Irs, Irs, Irs, Irs, Xoc, Xoc, Irs, Xoc, Ch, Irs, Ch, Xoc, Irs, Xoc, Xoc, Irs, Irs, Irs, Irs, Irs, Irs, Irs, Irs, Irs, Xoc, Xoc, Irs, Xoc, Rrc, Rrc, Xoc
Xoc, Rrc, Rrc, Xoc, Irs, Irs, Irs, Xoc, Xoc, Irs, Irs, Irs, Irs, Irs, Xoc, Xoc, Irs, Irs, Irs, Xoc, Dd^Ftd, Ch, Dd^Ftd, Xoc, Irs, Irs, Irs, Xoc, Xoc, Irs, Irs, Irs, Irs, Irs, Xoc, Xoc, Irs, Irs, Irs, Xoc, Rrc, Rrc, Xoc
Xoc, Rrc, Rrc, Xoc, Irs, Irs, Irs, Irs, Xoi, Xoi, Xoi, Irs, Xoi, Xoi, Xoi, Irs, Irs, Irs, Irs, Xoc, Dd^Do, Rp, Dd^Do, Xoc, Irs, Irs, Irs, Irs, Xoi, Xoi, Xoi, Irs, Xoi, Xoi, Xoi, Irs, Irs, Irs, Irs, Xoc, Rrc, Rrc, Rrc
Xoc, Rrc, Rrc, Xoc, Irs, Irs, Irs, Irs, Xoi, Icn, Icn, Ch, Icn, Icn, Xoi, Irs, Irs, Irs, Irs, Xoc, Dd^Ftd, Rp, Dd^Ftd, Xoc, Irs, Irs, Irs, Irs, Xoi, Icn, Icn, Ch, Icn, Icn, Xoi, Irs, Irs, Irs, Irs, Xoc, Rrc, Rrc, Xoc
Xoc, Rrc, Rrc, Xoc, Xoc, Irs, Irs, Irs, Xoi, Icn, Icn, Icn, Icn, Icn, Xoi, Irs, Irs, Irs, Xoc, Xoc, Ds^Edb, Rp, Ds^Edb, Xoc, Xoc, Irs, Irs, Irs, Xoi, Icn, Icn, Icn, Icn, Icn, Xoi, Irs, Irs, Irs, Xoc, Xoc, Rrc, Rrc, Xoc
Xoc, Rrc, Rrc, Rrc, Rrc, Xoc, Xoc, Irs, Xoi, Icn, Icn, Icn, Icn, Icn, Xoi, Irs, Xoc, Xoc, Ds^Edb, Ds^Edb, Wot^Edb, Rr, Wot^Edb, Ds^Edb, Ds^Edb, Xoc, Xoc, Irs, Xoi, Icn, Icn, Icn, Icn, Icn, Xoi, Irs, Xoc, Xoc, Rrc, Rrc, Rrc, Rrc, Xoc
Xoc, Rrc, Rrc, Rrc, Rrc, Rrc, Rrc, Xoc, Xoi, Icn, Icn, Icn, Icn, Icn, Xoi, Xoc, Ds^Edb, Ds^Edb, Wot^Edb, Wot^Edb, Wot, Qxu^Bcx|, Wot, Wot^Edb, Wot^Edb, Ds^Edb, Ds^Edb, Xoc, Xoi, Icn, Icn, Icn, Icn, Icn, Xoi, Xoc, Rrc, Rrc, Rrc, Rrc, Rrc, Rrc, Rrc
Xoc, Rrc, Rrc, Rrc, Rrc, Rrc, Rrc, Ch, Rb, Xoi, Xoi, Icn, Xoi, Xoi, Ds^Edb, Ds^Edb, Wot^Edb, Wot^Edb, Wot, Wot, Wot, Qxu^Bcx|, Wot, Wot, Wot, Wot^Edb, Wot^Edb, Ds^Edb, Ds^Edb, Xoi, Xoi, Icn, Xoi, Xoi, Rb^Edb, Ch, Rrc, Rrc, Rrc, Rrc, Rrc, Rrc, Xoc
Xoc, Rrc, Rrc, Rrc, Xoi, Rrc, Ch, Ch, Rr, Re^Edb, Rd^Edb, Xoi, Ds^Edb, Ds^Edb, Wot^Edb, Wot^Edb, Wot, Wot, Wot, Wot, Wot, Qxu^Bcx|, Wot, Wot, Wot, Wot, Wot, Wot^Edb, Wot^Edb, Ds^Edb, Ds^Edb, Xoi, Rd^Edb, Re^Edb, Rr, Ch, Ch, Rrc, Xoi, Rrc, Rrc, Rrc, Xoc
Xoc, Rrc, Rrc, Xoi, Iwr, Xoi, Xoi, Rb^Edb, Re^Edb, Rr, Rr, Ds^Edb, Wot^Edb, Wot^Edb, Wot, Wot, Wot, Wot, Wot, Wot, Ww^Ewf, Qxu^Bcx|, Ww^Ewf, Wot, Wot, Wot, Wot, Wot, Wot, Wot^Edb, Wot^Edb, Ds^Edb, Rr, Rr, Re^Edb, Rb^Edb, Xoi, Xoi, Iwr, Xoi, Rrc, Rrc, Xoc
Xoc, Rrc, Rrc, Xoc^Edb, Iwr, Iwr, Iwr, Xoi, Xoi, Rd^Edb, Ds^Edb, Rr, Qxu^Bcx\, Wot, Wot, Wot, Wot, Wot, Ww^Ewf, Ww^Ewf, Mm^Xm, Qxu^Bcx|, Mm^Xm, Ww^Ewf, Ww^Ewf, Wot, Wot, Wot, Wot, Wot, Qxu^Bcx/, Rr, Ds^Edb, Rd^Edb, Xoi, Xoi, Iwr, Iwr, Iwr, Xoi, Rrc, Rrc, Xoc
Xoc, Rrc, Rrc, Xoi, Iwr, Iwr, Iwr, Iwr, Iwr, Xoi, Ds^Edb, Wot^Edb, Wot, Qxu^Bcx\, Qxu^Bcx\, Wot, Ww^Ewf, Ww^Ewf, Mm^Xm, Mm^Xm, Xoc, Irs, Xoc, Mm^Xm, Mm^Xm, Ww^Ewf, Ww^Ewf, Wot, Qxu^Bcx/, Qxu^Bcx/, Wot, Wot^Edb, Ds^Edb, Xoi, Iwr, Iwr, Iwr, Iwr, Iwr, Xoi, Rrc, Rrc, Xoc
Xoc, Rrc, Rrc, Xoi, Iwr, Iwr, Iwr, Iwr, Iwr, Xoi, Ds^Edb, Wot^Edb, Wot, Wot, Wot, Qxu^Bcx\, Qxu^Bcx\, Mm^Xm, Xoc, Xoc, Irs, Irs, Irs, Xoc, Xoc, Mm^Xm, Qxu^Bcx/, Qxu^Bcx/, Wot, Wot, Wot, Wot^Edb, Ds^Edb, Xoi, Iwr, Iwr, Iwr, Iwr, Iwr, Xoi, Rrc, Rrc, Xoc
Xoc, Rrc, Rrc, Xoi, Xoi, Xoi, Xoi, Xoi, Xoi, Xoi, Ds^Edb, Wot^Edb, Wot, Wot, Wot, Ww^Ewf, Mm^Xm, Irs, Irs, Irs, Irs^Ebn, Irs^Ebn, Irs^Ebn, Irs, Irs, Irs, Mm^Xm, Ww^Ewf, Wot, Wot, Wot, Wot^Edb, Ds^Edb, Xoi, Xoi, Xoi, Xoi, Xoi, Xoi, Xoi, Rrc, Rrc, Xoc
Xoc, Rrc, Rrc, Xoi, Ior, Ior, Ior, Ior, Ior, Xoi, Ds^Edb, Wot^Edb, Wot, Wot, Wot, Ww^Ewf, Mm^Xm, Xoc, Irs, Irs, 4 Kha, 5 Kha, 3 Kha, Irs, Irs, Xoc, Mm^Xm, Ww^Ewf, Wot, Wot, Wot, Wot^Edb, Ds^Edb, Xoi, Ior, Ior, Ior, Ior, Ior, Xoi, Rrc, Rrc, Xoc
Xoc, Rrc, Rrc, Ch, Ior, Ior, Ior, Ior, Ior, Xoi, Ds^Edb, Wot^Edb, Wot, Wot, Wot, Ww^Ewf, Mm^Xm, Xoc, Irs, Irs^Ebn, 2 Kha, Irs, 1 Kha, Irs^Ebn, Irs, Xoc, Mm^Xm, Ww^Ewf, Wot, Wot, Wot, Wot^Edb, Ds^Edb, Xoi, Ior, Ior, Ior, Ior, Ior, Ch, Rrc, Rrc, Xoc
Xoc, Rrc, Rrc, Xoi, Xoi, Ior, Xoi, Ior, Xoi, Xoi, Ds^Edb, Wot^Edb, Wot, Wot, Wot, Ww^Ewf, Mm^Xm, Xoc, Irs, Irs, Irs, Irs^Wm, Irs, Irs, Irs, Xoc, Mm^Xm, Ww^Ewf, Wot, Wot, Wot, Wot^Edb, Ds^Edb, Xoi, Xoi, Ior, Xoi, Ior, Xoi, Xoi, Rrc, Rrc, Xoc
Xoc, Rrc, Rrc, Xoi, Iwr, Xoi, Iwr, Xoi, Iwr, Xoi, Ds^Edb, Wot^Edb, Wot, Wot, Wot, Ww^Ewf, Qxu^Bcx/, Irs, Xoc, Irs, Xos, Irs, Xos, Irs, Xoc, Irs, Qxu^Bcx\, Ww^Ewf, Wot, Wot, Wot, Wot^Edb, Ds^Edb, Xoi, Iwr, Xoi, Iwr, Xoi, Iwr, Xoi, Rrc, Rrc, Xoc
Xoc, Rrc, Rrc, Xoi, Iwr, Iwr, Iwr, Iwr, Iwr, Xoi, Ds^Edb, Wot^Edb, Wot, Wot, Qxu^Bcx/, Qxu^Bcx/, Ww^Ewf, Mm^Xm, Mm^Xm, Xoc, Mm^Xm, Xos, Mm^Xm, Xoc, Mm^Xm, Mm^Xm, Ww^Ewf, Qxu^Bcx\, Qxu^Bcx\, Wot, Wot, Wot^Edb, Ds^Edb, Xoi, Iwr, Iwr, Iwr, Iwr, Iwr, Xoi, Rrc, Rrc, Xoc
Xoc, Rrc, Rrc, Xoi, Iwr, Iwr, Iwr, Iwr, Xoi, Xoi, Ds^Edb, Wot^Edb, Qxu^Bcx/, Qxu^Bcx/, Wot, Wot, Wot, Ww^Ewf, Ww^Ewf, Mm^Xm, Ww^Ewf, Mm^Xm, Ww^Ewf, Mm^Xm, Ww^Ewf, Ww^Ewf, Wot, Wot, Wot, Qxu^Bcx\, Qxu^Bcx\, Wot^Edb, Ds^Edb, Xoi, Xoi, Iwr, Iwr, Iwr, Iwr, Xoi, Rrc, Rrc, Xoc
Xoc, Rrc, Rrc, Xoi, Iwr, Iwr, Xoi, Xoi, Re^Edb, Rd^Edb, Rr, Rr, Wot^Edb, Wot, Wot, Wot, Wot, Wot, Wot, Ww^Ewf, Wot, Ww^Ewf, Wot, Ww^Ewf, Wot, Wot, Wot, Wot, Wot, Wot, Wot^Edb, Rr, Rr, Rd^Edb, Re^Edb, Xoi, Xoi, Iwr, Iwr, Xoi, Rrc, Rrc, Xoc
Xoc, Rrc, Rrc, Xoi, Xoi, Xoi, Cud, Rb^Edb, Rr, Rr, Rd^Edb, Ds^Edb, Ds^Edb, Wot^Edb, Wot^Edb, Wot, Wot, Wot, Wot, Wot, Wot, Wot, Wot, Wot, Wot, Wot, Wot, Wot, Wot^Edb, Wot^Edb, Ds^Edb, Ds^Edb, Rd^Edb, Rr, Rr, Rb^Edb, Cud^Ii, Xoi, Xoi, Xoi, Rrc, Rrc, Xoc
Xoc, Rrc, Xoi, Xoi, Urc, Urc, Urc, Cud, Rb^Edb, Re^Edb, Xoc, Xoc, Xoc, Ds^Edb, Ds^Edb, Wot^Edb, Wot^Edb, Wot^Edb, Wot^Edb, Wot^Edb, Wot^Edb, Wot^Edb, Wot^Edb, Wot^Edb, Wot^Edb, Wot^Edb, Wot^Edb, Wot^Edb, Ds^Edb, Ds^Edb, Xoc, Xoc, Xoc, Re^Edb, Rb^Edb, Cud^Ii, Urc^Ii, Urc^Ii, Urc^Ii, Xoi, Xoi, Rrc, Xoc
Xoi, Xoi, Urc, Urc, Urc, Urc, Urc, Cud, Xoc, Xoc, Urc, Urc, Urc, Xoc, Xoc, Ds^Edb, Ds^Edb, Ds^Edb, Ds^Edb, Ds^Edb, Ds^Edb, Wot^Edb, Ds^Edb, Ds^Edb, Ds^Edb, Ds^Edb, Ds^Edb, Ds^Edb, Xoc, Xoc, Urc^Ii, Urc^Ii, Urc^Ii, Xoc, Xoc, Cud^Ii, Urc^Ii, Urc^Ii, Urc^Ii, Urc^Ii, Urc^Ii, Xoi, Xoc
Xoc, Urc, Urc, Urc, Urc, Urc, Xoc, Xoc, Urc, Urc, Urc, Urc, Xoc, Xoc, Xoc, Xoc, Xoc, Xoc, Xoc, Xoc, Xoc, Xoc, Xoc, Xoc, Xoc, Xoc, Xoc, Xoc, Xoc, Xoc, Xoc, Urc^Ii, Urc^Ii, Urc^Ii, Urc^Ii, Xoc, Xoc, Urc^Ii, Urc^Ii, Urc^Ii, Urc^Ii, Urc^Ii, Xoc
Xoc, Urc, Urc, Urc, Urc, Xoc, Xoc, Urc, Urc, Xoc, Xoc, Xoc, Urc, Urc, Xoc, Urc, Urc, Urc, Cud, Cud, 7 Kud, Xoc, 6 Kud, Cud^Ii, Cud^Ii, Urc^Ii, Urc^Ii, Urc^Ii, Xoc, Urc^Ii, Urc^Ii, Xoc, Xoc, Xoc, Urc^Ii, Urc^Ii, Xoc, Xoc, Urc^Ii, Urc^Ii, Urc^Ii, Urc^Ii, Xoc
Xoc, Urc, Xoc, Urc, Urc, Urc, Urc, Xoc, Xoc, Urc, Urc, Urc, Urc, Urc, Xoc, Urc, Urc, Urc, Cud, Cud, Cud, Xoc, Cud^Ii, Cud^Ii, Cud^Ii, Urc^Ii, Urc^Ii, Urc^Ii, Xoc, Urc^Ii, Urc^Ii, Urc^Ii, Urc^Ii, Urc^Ii, Xoc, Xoc, Urc^Ii, Urc^Ii, Urc^Ii, Urc^Ii, Xoc, Urc^Ii, Xoc
Xoc, Xoc, Urc, Xoc, Xoc, Urc, Urc, Urc, Urc, Xoc, Xoc, Urc, Urc, Urc, Xoc, Urc, Urc, Urc, Urc, Cud, Cud, Xoc, Cud^Ii, Cud^Ii, Urc^Ii, Urc^Ii, Urc^Ii, Urc^Ii, Xoc, Urc^Ii, Urc^Ii, Urc^Ii, Xoc, Xoc, Urc^Ii, Urc^Ii, Urc^Ii, Urc^Ii, Xoc, Xoc, Urc^Ii, Xoc, Xoc
Xoc, Urc, Urc, Urc, Urc, Xoc, Xoc, Urc, Urc, Urc, Urc, Urc, Urc, Xoc, Urc, Xoc, Urc, Urc, Urc, Urc, Urc, Xoc, Urc^Ii, Urc^Ii, Urc^Ii, Urc^Ii, Urc^Ii, Xoc, Urc^Ii, Xoc, Urc^Ii, Urc^Ii, Urc^Ii, Urc^Ii, Urc^Ii, Urc^Ii, Xoc, Xoc, Urc^Ii, Urc^Ii, Urc^Ii, Urc^Ii, Xoc
Xoc, Urc, Urc, Urc, Urc, Urc, Urc, Urc, Urc, Urc, Urc, Urc, Urc, Urc, Urc, Urc, Urc, Urc, Urc, Urc, Urc, Xoc, Urc^Ii, Urc^Ii, Urc^Ii, Urc^Ii, Urc^Ii, Urc^Ii, Urc^Ii, Urc^Ii, Urc^Ii, Urc^Ii, Urc^Ii, Urc^Ii, Urc^Ii, Urc^Ii, Urc^Ii, Urc^Ii, Urc^Ii, Urc^Ii, Urc^Ii, Urc^Ii, Xoc
Xoc, Urc, Urc, Urc, Urc, Urc, Urc, Urc, Urc, Urc, Urc, Urc, Urc, Urc, Urc, Urc, Urc, Urc, Urc, Urc, Urc, Xoc, Urc^Ii, Urc^Ii, Urc^Ii, Urc^Ii, Urc^Ii, Urc^Ii, Urc^Ii, Urc^Ii, Urc^Ii, Urc^Ii, Urc^Ii, Urc^Ii, Urc^Ii, Urc^Ii, Urc^Ii, Urc^Ii, Urc^Ii, Urc^Ii, Urc^Ii, Urc^Ii, Xoc
